NO ./path_to_the_north_texture
SO ./path_to_the_south_texture
WE ./path_to_the_west_texture
EA ./path_to_the_east_texture

F 220,100,0
C 225,30,0


            111111111111111111111111111111
          11111000000000000000000000001111
      111110000000000000000000000000001111
    11100000000000000011111111111111111111
1111100000000000000011111
111100000000000000011111
110000000000000001111111
110000000000000001111111
100000011111100000011
11000001    10000111
11000001    1000011111
1100000111111000000011111
111000000000000000111111111111111111
111000000000000000111111111111111111
111110000000000111111111111
11100000000001111111111
110000000000111111
100000000001111
11000000000011111111                    111111111111
110000000000111111111111                  1100000001
110000000000111111111111111111             100001
110000000000111111111111111111           111001
1100000001111                         11110001111111
11110000000111111111               11110000111
11110000000111111111               10000001111
1100000000000000111111111111111111110011111
110000000000000011111111111111110000011
110000000000000011111111111110000000111
111111000000000000000000000000000011111
111111111111111111111111111111111111111111
