NO ./texture/path_to_the_north_texture
SO ./texture/path_to_the_south_texture
WE ./texture/path_to_the_west_texture
EA ./texture/path_to_the_east_texture

F 220,100,20
C 225,30,0

        1111111111111111111111111
        1000000000110000000000001
        1011000001110000000000001
        100D000000000000000000001
111111111011000001110000000000001
10000000001100000111D111111111111
1111D111111111000000000000001
11110111111111011101010010001
11000000110101011100000010001
10000T000000000011000000D0001
1000000000000000D001010010001
100000111010D011111011110N0111
11110111 1110101 101111010001
11111111 1111111 111111111111


