NO ./img/walltt30px.xpm
SO ./img/walltt30px2.xpm
WE ./img/walltt30px3.xpm
EA ./img/walltt30px4.xpm

F 70,33,92
C 225,30,0

        1111111111111111111111111
        1000000000110000000000001
        1011000001110000000000001
        1001000000000000000000001
111111111011000001110000000000001
10000000001100000111D111111111111
11110111111111000000000000001
11110111111111011101010010001
110000001101010111000000D0001
1000000000000000D000000010001
10000000000000001101010010001
1000001110101011111011110N0111
11110111 1110101 101111010001
11111111 1111111 111111111111


